red: 0,A
green: 1,B
++++++++++++
+1       +a+
+        + +
+   b    +B+
+        + +
+    0A    +
++++++++++++
