blue: 0,1,3,A,B,C
red: 2,D
++++++++++++++++++++++
+0                 Bb+
+1                 Aa+
++3        +         +
++2      Dd+Cc       +
++++++++++++++++++++++


