red: 0,A
green: 1,B 
blue: 2,C
++++++++++++
+      A0+a+
+ ++++++++ +
+          +
+ ++++++++ +
+b+1B     c+
++++++++++ +
+2C        +
++++++++++++