red: 0,A
green: 1,B 
+++++++++++++
+   A01B    +
+ ++++++++  +
+    ba     +
+++++++++++++