++++++++++++++++++++++++++++
+                          +
+     0                Aa  +
+ +++++++++++++++++        +
+                          +
++++++++++++++++++++++++++++
