red: 0,A,B
++++++++++++
+0A        +
+        + +
+        +B+
+        +a+
++++++++++++