+++++++++++++++++++++++++++++++++++++++++++++++++++++++++++++++++++++
0 +   +     +   +       +     +       +         +                 + +
+ + + +++++ + + + +++++ + +++++ +++++ +++++++++ + +++++++++++++++ + +
+ + +   +   + +   +   + +     + +   + +         +     +           + +
+ + +++ + +++ +++++ + + + +++ + + +++ + +++++++++++++ + + +++++++++ +
+   +   +     +   + + + + +   + +       +   + +     + + + +   +     +
+++++ +++ +++++ +++ + + + + +++ +++++++++ + + + +++ + +++ + + + +++ +
+     +   + +     + +   + + +   + +     + + +   + +   +   + +   +   +
+ +++++ +++ + + + + +++++ + + +++ + +++++ + + +++ +++++ +++ + + +++++
+ +     +     + +   +     + + +   + +     + +   + +   +   + + + +   +
+ + +++++++++++++++++ +++++ + + + + + + +++ +++ + + + +++ +++ +++ + +
+ +               + + +   + + + +   + + + +   + + + +       +   + + +
+ +++ +++++++++++ + + + + + + + +++++++ + +++ + + + +++++++ + + + + +
+     +     + +   + + + + +   +         +   + + + +     +   + + + + +
+++++++ +++ + + +++ + + + +++++++++++++++++ + + + +++++++ +++ + + + +
+   +   +     + +   + + +     +       +       +   +       +   + + + +
+ + +++++ + +++ + +++ + +++++ + +++++ + +++ +++++++ +++++++ +++ + + +
+ +       + +   +   +   +   + + +     + +   +     + +     +   +   + +
+ +++++++++++ +++ + + +++ + + + + +++++ +++++++++ + +++ + +++ +++++ +
+ + +   +     +   +     + +     +   +       +   +       + + + +     +
+ + + + +++ +++ +++++++++ +++ +++++ + +++++ + + + +++++ + + + + +++++
+ +   + +     + +         + + +     + +   + + +   +   + +   + +   + +
+ +++++ + +++++ + +++++++++ + +++++++++ + + + +++++ +++ +++ + +++ + +
+     +         + + +   +   +   +       +   +   + +     +   + +   + +
+++++ +++ +++++++ + + + + +++++ + +++++++++++++ + + +++++ + + + +++ +
+   + +       +   + + +   +       +       +   +   + +     + + +     +
+ + + +++++++++ +++ + +++++ +++++++ +++++ + + +++++ + +++++ + +++++++
+ +   +   +     +   +   +   +       +     + +       +     +   +     +
+ + +++ +++ +++++ +++ + + +++ +++++++ +++++ +++++++ + + +++++++++ + +
+ +     +           + + +   + +     +       +       + +           + +
+ +++++++ +++++++++ +++ + +++ + + + +++++++++ +++ +++++++++++++++++ +
+ +     + +   +   +     +     + + +   +       +                 +   +
+ + +++ + + + + + +++++++++++++ + +++ +++++++++ +++++++ +++++++ + +++
+   + +   + +   +     +     + + +   +         + +     + +   +   +   +
+ +++ +++++ +++++++++ + +++ + + +++ +++++++++ + + +++ + + + + +++++ +
+ +     +   +     +   + +   +   +     +   +       +   + + + +     + +
+ + +++++ +++ +++ + + + + +++++++++++++ +++ + +++++ +++ + + +++++++ +
+   +     +   + + + + + +     +       +   + + +       + + +   +     +
+++ + +++++ +++ + + +++ + +++ + +++++ + + + + +++++++ +++ +++ + +++++
+   + +   +   +   +     + +   + +   + + +   +     +   +   + + +     +
+ +++ + +++++ +++++++++++++ +++ + + + +++++++ +++ + +++ + + + +++++ +
+ +   + +   + +         +   +   + + +   +   + +   +     + + +     + +
+ + +++ + + + +++++++++ + +++ +++ +++ + +++ + + +++++++++++ +++++ + +
+ +   +   + +             +   + +     + +   + +       +   +       + +
+ +++ + +++ +++ +++++++ +++ +++ +++++++ + +++++++++++ + + +++++++++ +
+ +   +   +   +     +     + + + +     +             + + +   +     + +
+ + +++++ +++ +++++ +++++ + + + + +++ +++ +++++++++++ + +++ + +++ + +
+   +   + + + +     +     +   + + +   +       +   +   + + +   + + + +
+++++ +++ + + +++++++ +++++++ + + + +++ +++++++ + + +++ + +++ + + + +
+   +     +   +   +         +     +   +   +     +   + + +   +   +   +
+ +++ +++++++ + + +++++++++ +++ +++++ +++ + +++++++++ + +++ +++++++++
+   +   +   +   + +   +   +     +   + +   + +       + +     +       +
+ + +++ + + +++++ + +++ + +++++++++ + + +++ + +++++ + +++++++ +++++ +
+     + + + +   + + +   +     +       +       +   + + +     +     + +
+ +++ + + + + + + + + +++++++ + +++++++++ +++++++ + + + +++ +++++++ +
+ + + +   +   + + +       +   +   +   +         + +   + +     +     +
+ + + +++++++++++ +++ + + + +++++ +++ +++++++++ + + +++ + +++++ + +++
+   +   +   + +   +   + + + +       + +   +     +       +       +   +
+++++ + + + + + +++++++++ + + +++ + + + +++ +++++++++++++++++++++++++
+   + + + + + +   +   +   +   +   +   +     +     +                 +
+ + +++ +++ + +++ + + + +++++ + + +++++++++++++ +++ + +++++ +++++++ +
+ +           + +   +   +     + + +     +     + +   +   +     + +   +
+ +++++ +++ +++ +++ +++++++++++ + +++ + + +++ + + +++++ +++++ + + +++
+   +   +   +   + +     +       + +   +   +   +       +   + + +     +
+ +++ +++ +++ + + +++++ + +++++++ + +++++++ +++++++++++++ + + +++ + +
+ +   +   +   +     +   + +   +   + +   +   +   +   +     +   +   + +
+ + +++++++ +++++++ + +++ +++ + +++ + + + +++ + + + + +++++++++ +++ +
+A+               +   +       +     + +       +   +   +         +a  +
+++++++++++++++++++++++++++++++++++++++++++++++++++++++++++++++++++++