red: 0,A
green: 1,B 
++++++++++++
+0A        +
+1       + +
+        +B+
+        +a+
++++++++++++