red: 0,A
green: 1,B 
++++++++++++
+      A0+a+
+ ++++++++ +
+          +
+ ++++++++ +
+b+1B      +
++++++++++++
